###       B          #########
#   ##### #############   # #
# ####                # # # #
# ############ ###### # # # #
#                     # # # #
##################### # # # #
#   ##                # # # #
# # ## ### ## ######### # # #####
# #    #   ###         # # #
######### ###############
             ####################
A      ######################